     1111111111111
     1C000000000C1
     1000001010111
     1000001011111
1111111000011
1PC00000000E1
111111000111111111111111
    11000000000000000001
    11111111111111111111