     1111111111111
     1000000000001
     1000001111111
11111110S0011
1000000000001
11101111110011111111111111
  101    10000000000000001
  101    1111111100001111111
  101           100000000001
  10111111111111100000000001
  10000000000000000000000001
  11111110011111111111111111
        1001
        1001   1111111111
        1001   1000000001
        10011111001111111
        10000000001
        10011111111
        1111