NO ./texture/north.png
SO ./texture/south.png
WE ./texture/west.png
EA ./texture/east.png

F 255,204,0
C 186,73,72

111111011111111111
100000000000000001
100010000000000001
1000000S0001000001
100001000000000001
100000000111100001
100000000000000001
111111111001111111
        1001
        1001
        1001
        1001
        1001
        1001
        1001
        1001
        1001
        1001
        1001
        1001
        1001
        1001
        1001
        1001
        1001
        1001
        1001
        1001
        1001
        1001
        1001
        1001
        1001
        1001
        1001
        1001
        1001
        1001
        1001
        1001
        1001
        1001
        1001
        1001
        1001
        1001
        1001
        1001
        1001
        1001
        1001
        1001
        1001
        1001
        1001
        1001
        1001
        1001
        1001
        1001
        1001
        1001
        1111