     1111111111111
     1N00000000001
     1000001011111
1111111000011
1000000000001
11111111110011111111111111
         10000000000000001
         1111111100001111111
                100000000001
  11111111111111100000000001
  10000000000000000000000001
  11111111111100111111111111
             1001
             1001   1111111
             1001   1000001
             10011111001111
             10000000001
             10011111111
             1111