NO ./texture/north.png
SO ./texture/south.png
WE ./texture/west.png
EA ./texture/east.png

F 255,255,0
C 123,121,0


111111111111111111
100000000000000001
100010000000000001
100000000001000001
100001000000000001
10000000011110S001
100000000000000001
111111111111111111
        1001
        1001
        1001
        1001
        1001
        1001
        1001
        1001
        1001
        1001
        1001
        1001
        1001
        1001
        1001
        1001
        1001
        1001
        1001
        1001
        1001
        1001
        1001
        1001
        1001
        1001
        1001
        1001
        1001
        1001
        1001
        1001
        1001
        1001
        1001
        1001
        1001
        1001
        1001
        1001
        1001
        1001
        1001
        1001
        1001
        1001
        1001
        1001
        1001
        1001
        1001
        1001
        1001
        1001
        1111