xxxxx1111111111111xxxxxxxxxx
xxxxx1000000000001xxxxxxxxxx
xxxxx1000001011111xxxxxxxxxx
1111111000011xxxxxxxxxxxxxxx
1000000000001xxxxxxxxxxxxxxx
11111111110011111111111111xx
xxxxxxxxx10000000000000001xx
xxxxxxxxx1111111100001111111
xxxxxxxxxxxxxxxx100000000001
xx11111111111111100000000001
xx10000000000000000000000001
xx11111111111100111111111111
xxxxxxxxxxxxx1001xxxxxxxxxxx
xxxxxxxxxxxxx1001xxx1111111x
xxxxxxxxxxxxx1001xxx1000001x
xxxxxxxxxxxxx10011111001111x
xxxxxxxxxxxxx10000000001xxxx
xxxxxxxxxxxxx10N11111111xxxx
xxxxxxxxxxxxx1111xxxxxxxxxxx