NO ./texture/north.png
SO ./texture/south.png
WE ./texture/west.png
EA ./texture/east.png

F 255,204,0
C 186,73,72

     1111111111111
     1000000000001
     1000001010111
     1000001111111                 1111111
1111111000011                      1000001
1000000000001                      1000001
111111111100111111111111111111111111000001
         100000000000000000011111111000001
         111111110000001111111111111000001
                100000000000000000000000011111111111111111111111111111111111111111111111111111111111111111
                100000000000000000000000000000000000000000000000000000000000000000000000000000000000000001
                10000000000E000000000000000000000000000000000000000000000000000000000000000000000000000001
                100000000000000000000000111111111111111111111111111111111111111111111111111111111111111111
                11111111111111111111111111