     1111111111111
     1000000000001
     1000001010111
     1000001011111
1111111000011
1000000000001
11111111110011111111111111111
         10000000000000000001
         11111111111111111111