xxxxx1111111111111
xxxxx1N00000000001
xxxxx1000001011111
1111111000011
1000000000001
11111111110011111111111111
xxxxxxxxx10000000000000001
xxxxxxxxx1111111100001111111
xxxxxxxxxxxxxxxx100000000001
xx11111111111111100000000001
xx10000000000000000000000001
xx11111111111100111111111111
xxxxxxxxxxxxx1001
xxxxxxxxxxxxx1001   1111111
xxxxxxxxxxxxx1001   1000001
xxxxxxxxxxxxx10011111001111
xxxxxxxxxxxxx10000000001
xxxxxxxxxxxxx10011111111
xxxxxxxxxxxxx1111