     1111111111111
     1000000000001
     1000001010111
     1000001011111                 1111111
1111111000011                      1000001
1000000000001                      1000001
111111111100111111111111111111111111000001
         100000000000000000N11111111000001
         111111110000001111111111111000001
                100000000000000000000000011111111111111111111111111111111111111111111111111111111111111111
                100000000000000000000000000000000000000000000000000000000000000000000000000000000000000001
                100000000000000000000000000000000000000000000000000000000000000000000000000000000000000001
                100000000000000000000000011111111111111111111111111111111111111111111111111111111111111111
                11111111111111111111111111