NO ./texture/pinochet.png
SO ./texture/mao.png
WE ./texture/stalin.png
EA ./texture/tito.png

F 135,235,164
C 136,205,235

111111111111111111
100000000000000001
100010000000000001
1000000S0001000001
100001000000000001
100000011111100001
100000000000000001
111111111001111111
        1001
        1001
        1001
        1001
        1001
        1001
        1001
        1001
        1001
        1001
        1001
        1001
        1001
        1001
        1001
        1001
        1001
        1001
        1001
        1001
        1001
        1001
        1001
        1001
        1001
        1001
        1001
        1001
        1001
        1001
        1001
        1001
        1001
        1001
        1001
        1001
        1001
        1001
        1001
        1001
        1001
        1001
        1001
        1001
        1001
        1001
        1001
        1001
        1001
        1001
        1001
        1001
        1001
        1001
        1111